1111111
10P0001
10CE001
1111111
