1111111
1000001
1E0P0C1
1111111
