1111111
10P0001
1E000C1
1111111
